uint8_t test_dungeon_raycast0 = {
9, 9,
4,4,
1,1,1,1,1,1,1,1,1,
1,0,0,0,1,1,1,1,1,
1,0,1,0,1,1,1,1,1,
1,0,1,0,3,3,1,1,1,
1,0,1,0,0,3,1,1,1,
1,0,0,0,3,3,1,1,1,
1,0,4,4,1,1,1,1,1,
1,0,0,4,1,1,1,1,1,
1,4,4,4,1,1,1,1,1
};
uint8_t test_dungeon_raycast1 = {
9, 9,
4,4,
1,1,1,1,1,1,1,1,1,
1,1,1,1,1,1,1,1,1,
1,1,1,1,1,1,1,1,1,
1,1,1,3,3,0,0,0,1,
1,1,1,3,0,0,1,0,1,
1,1,1,3,3,0,0,0,1,
1,1,1,1,0,0,4,4,1,
1,1,1,1,0,0,0,4,1,
1,1,1,1,1,4,4,4,1
};

uint24_t test_dungeon_raycast_floors[] = { test_dungeon_raycast0 ,test_dungeon_raycast1  };
