uint8_t test_dungeon0 = {
9, 9,
4,4,
1,1,1,1,1,1,1,1,1,
1,1,1,2,2,2,2,2,1,
1,1,1,2,1,1,1,2,1,
1,1,1,2,1,1,1,2,1,
1,1,1,2,3,1,1,2,1,
1,1,1,1,1,1,1,2,1,
1,1,4,1,1,1,1,2,1,
1,1,9,2,2,2,2,2,1,
1,1,1,1,1,1,1,1,1
};
uint8_t test_dungeon1 = {
9, 9,
4,4,
1,1,1,1,1,1,1,1,1,
1,1,1,2,2,2,9,1,1,
1,1,1,2,1,1,4,1,1,
1,2,2,2,1,1,1,1,1,
1,2,1,1,3,2,1,1,1,
1,2,1,1,1,2,2,2,1,
1,2,1,1,1,1,1,2,1,
1,2,2,2,2,2,2,2,1,
1,1,1,1,1,1,1,1,1
};

uint24_t test_dungeon_floors[] = { test_dungeon0 ,test_dungeon1  };
