uint8_t test_dungeon0 = {
1,1,1,1,1,1,1,1,1,1,1,1,1,1,1,1,1,1,1,1,1,1,1,1,1,1,1,1,1,1,1,1,1,1,1,1,1,1,1,1,1,1,1,1,1,1,1,1,1,1,1,1,1,1,1,1,1,1,1,1,1,1,1,1
1,1,1,1,1,1,2,2,2,2,2,2,2,2,2,1,1,1,1,1,1,1,1,1,1,1,1,1,1,1,1,1,1,1,1,1,1,1,1,1,1,1,1,1,1,1,2,2,2,2,2,2,2,2,2,2,2,2,2,2,2,2,2,1
1,1,5,5,5,5,2,1,2,1,1,1,1,1,2,1,1,1,1,1,1,1,1,1,1,1,1,1,1,1,1,1,1,1,1,1,1,1,2,2,2,1,1,1,1,1,2,1,1,1,1,1,1,1,1,1,1,1,1,1,1,1,2,1
1,1,5,5,5,5,1,1,2,1,1,1,1,1,2,1,1,1,1,1,1,1,1,1,1,1,1,1,1,1,1,1,1,1,1,1,1,1,2,1,2,1,1,1,1,1,2,1,1,1,1,1,1,1,1,1,1,1,1,1,1,1,2,1
1,1,5,5,5,5,1,1,2,1,1,1,1,1,2,1,1,1,1,1,2,2,2,1,1,1,1,1,1,1,1,1,1,1,1,1,1,1,2,1,2,1,1,1,1,1,2,1,1,1,1,1,1,1,1,1,1,1,1,1,1,1,2,1
1,1,1,1,1,1,1,1,2,2,2,1,1,1,2,1,1,1,1,1,2,1,2,1,1,1,1,1,1,1,1,1,1,1,1,1,1,1,2,1,2,1,2,2,2,2,2,1,1,1,1,1,1,1,1,1,1,1,1,1,1,2,2,1
1,1,1,1,1,1,1,1,1,1,2,1,1,1,2,1,1,1,1,1,2,1,2,2,2,1,1,1,1,1,1,1,1,1,1,1,1,1,2,1,2,1,2,1,1,1,1,1,1,1,1,1,1,1,1,1,1,1,1,1,1,2,1,1
1,1,1,1,1,1,1,1,1,1,2,1,1,1,2,2,2,2,2,2,2,1,1,1,2,1,1,1,1,1,1,1,1,1,1,1,1,1,2,1,2,1,2,1,1,1,1,1,1,1,1,1,1,1,1,1,1,1,1,1,1,2,2,1
1,1,1,1,1,1,1,1,1,1,2,1,1,1,1,1,1,1,1,1,1,1,1,1,2,1,1,1,1,1,1,1,1,1,1,1,1,1,2,1,2,1,2,1,1,2,2,2,2,2,2,2,2,2,2,2,1,6,6,6,6,1,2,1
1,1,1,1,1,1,7,7,7,1,2,2,2,1,1,1,1,1,7,7,7,1,1,1,2,1,1,1,1,1,1,1,1,1,1,1,1,1,2,1,2,1,2,1,1,2,1,1,1,1,1,1,1,1,1,2,2,6,6,6,6,1,2,1
1,1,1,1,1,1,7,7,7,1,1,1,2,1,1,1,1,1,7,7,7,1,1,1,2,2,2,2,2,2,2,2,2,2,2,2,2,2,2,1,2,2,2,1,1,2,1,2,2,2,2,2,2,2,2,2,1,6,6,6,6,2,2,1
1,1,1,1,1,1,7,7,7,1,1,1,2,1,2,2,2,1,7,7,7,1,1,1,1,1,1,1,1,1,1,1,2,1,1,1,1,1,1,1,1,1,1,1,1,2,1,2,1,1,1,1,1,1,1,2,2,6,6,6,6,1,2,1
1,1,1,1,1,2,9,1,1,1,1,1,2,1,2,1,2,1,9,1,1,1,1,1,2,2,2,1,1,1,6,6,6,6,1,1,1,1,1,1,2,2,6,6,6,6,1,2,1,1,1,1,1,1,1,2,2,1,1,1,1,1,2,1
1,2,2,2,1,2,1,1,1,1,1,1,2,1,2,1,2,2,2,2,2,2,2,2,2,1,2,1,1,1,6,6,6,6,1,1,1,1,1,1,2,1,6,6,6,6,1,2,1,1,8,8,8,1,1,2,1,1,1,1,1,1,2,1
1,2,1,2,1,2,1,1,1,1,1,1,2,1,2,1,1,1,1,1,1,1,1,1,1,1,2,2,2,2,6,6,6,6,1,1,1,1,1,1,2,1,6,6,6,6,1,2,1,1,8,8,8,1,1,2,1,1,1,1,1,1,2,1
1,2,1,2,2,2,1,1,1,2,2,2,2,1,2,1,1,1,1,1,1,1,2,2,2,1,1,1,2,1,1,2,1,1,1,1,1,1,1,1,2,2,2,1,1,1,1,2,1,1,8,8,8,2,1,2,1,1,1,1,1,1,2,1
1,2,1,1,1,2,5,5,5,5,1,1,2,1,2,1,1,1,1,1,1,1,2,1,2,1,1,1,2,1,1,2,2,2,2,2,2,2,2,2,1,2,2,2,2,2,2,2,2,2,2,1,1,2,1,2,1,1,1,1,1,1,2,1
1,2,2,2,2,1,5,5,5,5,1,2,2,1,2,2,2,2,1,1,1,1,2,1,2,2,2,1,2,1,1,2,1,1,1,1,1,1,1,2,1,2,1,2,1,1,1,1,1,2,2,2,1,2,1,2,1,1,1,1,1,1,2,1
1,1,1,1,2,1,5,5,5,5,1,2,1,1,1,1,1,2,1,1,1,1,2,1,1,1,2,1,2,1,1,2,1,2,2,2,1,1,1,2,1,2,9,2,1,7,7,7,1,1,1,2,1,2,2,2,1,1,1,1,1,1,2,1
1,2,2,2,2,1,5,5,5,5,1,2,1,1,1,1,1,2,1,1,1,1,2,1,1,1,2,1,2,1,1,2,1,2,1,2,1,1,1,2,1,1,4,1,1,7,7,7,9,2,2,2,1,1,1,1,1,1,1,1,1,1,2,1
1,2,1,1,1,1,1,1,1,2,1,2,1,1,1,1,1,2,1,1,1,1,2,1,1,1,2,1,2,1,2,2,2,2,1,2,1,1,1,2,1,1,1,1,1,7,7,7,1,2,1,1,1,2,2,2,2,2,1,1,1,1,2,1
1,2,1,1,1,1,1,1,2,2,1,2,1,1,1,1,1,2,1,1,2,2,2,1,1,2,2,1,2,1,2,2,1,1,1,2,1,1,1,2,1,1,1,1,1,1,1,1,1,2,2,2,2,2,1,2,1,2,1,1,1,1,2,1
1,2,1,2,2,2,2,2,2,1,1,2,1,1,1,1,1,2,1,1,2,2,2,1,1,2,1,1,2,2,1,6,6,6,2,2,2,2,1,2,1,1,1,1,1,1,1,1,1,1,1,2,1,1,1,2,2,2,1,1,1,1,2,1
1,2,1,2,1,1,1,1,2,1,1,2,1,1,1,1,1,2,1,8,8,8,1,2,2,2,1,1,1,2,1,6,6,6,1,1,1,2,1,2,1,1,1,1,1,1,1,1,1,1,2,2,6,6,6,6,1,2,1,1,1,1,2,1
1,2,1,2,1,1,1,1,2,1,1,2,1,1,1,1,1,2,2,8,8,8,2,2,1,1,1,1,1,2,1,6,6,6,1,1,1,2,1,2,2,2,2,2,1,2,2,2,2,2,2,1,6,6,6,6,2,2,2,2,2,1,2,1
1,2,1,2,1,1,1,1,2,1,2,2,2,2,2,2,2,2,2,8,8,8,1,2,2,2,2,2,1,2,1,1,1,1,1,1,1,2,1,1,1,1,1,2,1,2,1,1,1,1,2,1,6,6,6,6,1,1,1,1,2,1,2,1
1,2,1,2,2,1,1,1,2,2,9,1,1,1,1,1,1,1,2,8,8,8,1,1,1,1,1,2,1,2,1,1,1,2,2,2,2,2,1,7,7,7,1,2,1,2,1,1,1,1,2,1,1,1,1,2,2,2,2,2,2,1,2,1
1,2,2,1,8,8,8,1,2,1,7,7,7,1,1,1,2,2,2,1,1,1,1,1,1,1,1,2,1,2,1,1,1,2,1,1,1,1,1,7,7,7,1,2,1,2,1,1,1,1,2,1,2,2,2,2,2,1,1,1,1,1,2,1
1,1,2,2,8,8,8,1,2,1,7,7,7,1,1,1,2,1,1,1,1,1,1,1,1,1,1,2,1,2,1,1,1,2,1,2,2,2,1,7,7,7,1,2,2,2,2,1,1,1,2,2,2,1,1,1,1,1,1,1,1,1,2,1
1,1,2,1,8,8,8,1,2,1,7,7,7,1,1,1,2,1,1,1,1,1,1,1,1,1,1,2,1,2,1,1,1,2,1,2,1,2,9,7,7,7,1,2,1,2,6,6,6,6,1,1,1,1,1,1,1,1,1,1,1,1,2,1
1,1,2,1,8,8,8,1,2,1,1,1,1,1,1,1,2,1,1,7,7,7,1,1,1,1,1,2,1,2,1,1,1,2,1,2,1,2,2,1,1,1,1,2,1,1,6,6,6,6,1,1,1,1,1,1,1,1,1,1,1,1,2,1
1,1,2,2,2,1,2,1,2,1,1,1,2,2,2,1,2,1,1,7,7,7,1,1,1,2,2,2,1,2,1,1,1,2,1,2,1,1,1,1,1,1,1,2,1,1,6,6,6,6,2,1,1,1,1,1,1,1,1,1,1,1,2,1
1,1,2,1,2,2,2,2,2,2,2,2,2,1,2,1,2,1,1,7,7,7,1,1,1,2,1,1,1,2,1,1,1,2,1,2,1,2,2,2,2,2,2,2,2,2,2,1,1,1,2,2,2,2,2,1,1,1,1,1,1,1,2,1
1,1,2,1,2,1,1,1,1,1,1,1,1,1,2,2,2,1,1,7,7,7,9,2,1,2,2,2,2,2,2,2,2,2,1,2,1,2,1,2,1,1,1,1,1,1,1,1,1,2,2,1,1,1,2,2,2,2,2,2,2,2,2,1
1,1,2,1,2,1,1,1,1,1,1,1,1,1,1,1,1,1,1,1,1,1,1,2,1,2,1,1,1,1,1,1,1,1,1,2,2,2,2,9,7,7,7,1,1,1,1,1,1,2,1,2,2,2,1,1,1,1,1,1,1,1,1,1
1,1,2,1,2,1,1,1,1,2,2,2,2,2,2,2,1,2,2,2,2,2,2,2,1,2,1,1,1,2,2,2,2,2,1,1,1,1,1,1,7,7,7,1,1,1,1,1,1,2,1,2,1,2,1,1,1,1,1,1,1,1,1,1
1,1,2,1,2,1,1,1,1,2,1,1,1,1,1,2,1,2,1,1,1,1,1,2,1,2,1,1,1,2,1,1,1,2,1,1,1,1,1,1,7,7,7,1,1,1,1,1,1,2,1,2,1,2,1,1,1,1,1,1,1,1,1,1
1,1,2,1,2,2,2,2,2,2,1,1,1,1,1,2,1,2,1,1,1,1,1,2,1,2,1,1,1,2,1,1,1,2,1,2,2,2,1,1,7,7,7,1,1,1,1,1,1,2,1,2,1,2,1,1,1,1,1,1,1,1,1,1
1,2,2,1,2,1,1,1,1,2,1,1,1,1,1,2,1,2,1,1,1,1,1,2,1,2,1,1,1,2,1,1,1,2,1,2,1,2,1,1,1,1,1,2,2,2,2,2,2,2,1,2,1,2,2,2,2,2,2,2,1,1,1,1
1,2,1,8,8,8,8,1,2,2,1,1,1,2,2,2,1,2,1,1,1,1,1,2,1,2,1,1,1,2,1,1,1,2,1,2,1,2,1,1,1,1,1,2,1,1,1,1,1,1,1,2,1,1,1,1,1,1,1,2,1,1,1,1
1,2,1,8,8,8,8,2,2,1,1,1,1,2,1,1,1,2,1,1,1,1,1,2,1,2,1,1,1,2,1,1,1,2,1,2,1,2,1,1,1,1,1,2,2,2,2,2,2,2,2,2,1,1,1,1,1,1,1,2,1,1,1,1
1,2,2,8,8,8,8,2,2,1,1,1,1,2,2,2,2,2,1,1,1,1,2,2,1,2,2,2,1,2,1,2,2,2,2,2,1,2,2,2,1,1,1,1,1,1,1,1,1,1,1,1,1,1,1,1,1,1,1,2,1,1,1,1
1,2,1,8,8,8,8,1,1,1,1,1,1,1,1,1,1,1,1,1,1,1,2,1,1,1,1,2,1,2,1,2,2,1,1,1,1,1,1,2,1,6,6,6,6,1,1,1,1,2,2,2,2,2,2,2,2,2,2,2,1,1,1,1
1,2,1,1,1,1,2,2,1,1,1,1,1,1,1,1,1,1,1,1,1,1,2,2,2,2,2,2,1,2,1,5,5,5,5,1,1,1,1,2,1,6,6,6,6,1,1,1,1,2,1,2,1,1,1,1,1,1,1,1,1,1,1,1
1,2,2,2,1,2,2,2,2,2,2,2,2,2,2,2,2,2,2,2,2,2,1,1,1,1,1,1,1,2,2,5,5,5,5,1,1,1,1,2,1,6,6,6,6,1,1,1,1,2,2,2,1,1,1,1,1,1,1,1,1,1,1,1
1,1,1,2,1,2,1,1,1,1,1,1,1,1,1,1,1,1,1,1,1,2,2,2,2,2,2,2,2,2,2,5,5,5,5,1,2,2,2,2,2,6,6,6,6,2,1,1,1,2,1,5,5,5,5,1,1,1,1,1,1,1,1,1
1,2,2,2,1,2,2,2,2,2,1,1,1,1,1,1,1,1,7,7,7,9,1,1,1,1,1,1,1,1,1,2,2,1,2,1,2,1,1,1,1,1,1,1,1,2,2,2,1,2,1,5,5,5,5,1,1,1,1,1,1,1,1,1
1,2,1,1,1,1,1,1,1,2,1,1,1,1,1,1,1,1,7,7,7,1,2,2,2,2,2,2,2,2,2,2,2,2,2,1,2,1,1,1,1,1,1,1,1,2,1,2,1,2,1,5,5,5,5,1,1,1,1,1,1,1,1,1
1,2,2,2,2,2,2,2,2,2,1,1,1,1,1,1,1,1,7,7,7,1,2,1,1,1,1,1,1,2,1,1,1,1,1,1,2,1,1,1,1,1,1,1,1,2,1,2,2,2,2,5,5,5,5,1,1,1,1,1,1,1,1,1
1,1,1,1,1,1,1,1,1,1,1,1,1,1,1,1,1,1,1,1,1,1,2,2,1,1,1,1,1,2,1,1,1,1,2,2,2,1,1,1,1,1,1,1,1,2,1,1,1,1,1,1,1,1,1,1,1,1,1,1,1,1,1,1
1,1,1,6,6,6,1,2,2,2,1,1,1,1,1,1,1,1,1,1,1,1,2,2,8,8,8,8,1,2,1,1,1,1,2,1,1,1,1,1,5,5,5,5,1,2,2,2,2,2,2,2,2,2,2,2,1,1,1,1,1,1,1,1
1,1,1,6,6,6,2,2,1,2,1,1,1,1,2,2,2,2,2,2,2,2,2,1,8,8,8,8,1,2,2,1,1,1,2,1,1,1,1,1,5,5,5,5,1,1,1,1,1,1,1,1,1,1,1,2,1,1,1,1,1,1,1,1
1,1,1,6,6,6,1,2,1,2,1,1,1,1,2,1,2,1,1,1,1,1,1,1,8,8,8,8,1,1,2,1,1,1,2,1,1,1,1,1,5,5,5,5,1,1,1,1,1,1,1,1,1,1,1,2,1,1,1,1,1,1,1,1
1,1,1,2,1,1,1,2,1,2,1,1,1,1,2,2,9,1,1,1,2,2,2,1,8,8,8,8,1,2,2,1,1,1,2,2,2,2,2,2,1,2,1,2,1,1,1,1,7,7,7,7,1,1,1,2,1,1,1,1,1,1,1,1
1,2,2,2,1,1,1,2,1,2,1,1,1,1,2,1,7,7,7,1,2,1,2,2,1,2,1,1,1,2,1,7,7,7,9,1,1,1,1,2,2,2,2,2,2,2,2,1,7,7,7,7,1,2,2,2,1,1,1,1,1,1,1,1
1,2,1,1,1,1,1,2,1,2,1,1,1,1,2,1,7,7,7,1,2,2,2,2,2,2,2,2,1,2,1,7,7,7,1,1,1,1,1,1,1,1,1,1,1,1,2,1,7,7,7,7,1,2,1,1,1,1,1,1,1,1,1,1
1,2,2,2,2,2,2,2,1,2,1,1,1,1,2,1,7,7,7,1,2,1,3,1,1,1,1,2,1,2,1,7,7,7,1,1,1,7,7,7,1,1,1,1,1,1,2,1,7,7,7,7,1,2,2,2,2,2,2,2,1,1,1,1
1,1,1,1,1,1,1,1,1,2,1,1,1,1,2,1,7,7,7,1,2,2,2,2,1,1,1,2,2,2,1,1,1,1,1,1,1,7,7,7,1,1,1,1,1,1,2,1,1,9,1,1,1,2,1,1,1,1,1,2,1,1,1,1
1,2,2,2,2,2,2,2,2,2,1,1,1,1,2,1,1,1,1,1,1,2,1,2,1,1,1,1,1,2,1,1,1,1,1,1,1,7,7,7,9,2,2,2,2,2,2,1,1,2,2,2,2,2,1,1,1,1,1,2,1,1,1,1
1,2,1,1,1,1,1,1,1,1,2,2,2,2,2,1,1,1,1,1,1,2,1,2,1,1,1,1,1,2,1,1,1,1,1,1,1,1,1,1,1,2,1,1,1,1,1,1,1,1,1,1,1,1,1,1,1,1,1,2,1,1,1,1
1,2,1,1,1,1,1,1,1,1,2,1,1,1,1,1,1,1,1,1,1,2,1,2,2,2,2,2,2,2,1,1,1,1,1,1,1,1,1,1,1,2,1,1,1,2,2,2,2,2,1,2,2,2,1,1,1,1,1,2,1,1,1,1
1,2,1,1,1,1,1,1,1,1,2,1,1,1,1,1,1,1,1,1,1,2,1,1,1,1,1,1,1,1,1,1,1,1,1,1,1,1,1,1,1,2,1,1,1,2,1,1,1,2,1,2,1,2,1,1,1,1,1,2,1,1,1,1
1,2,2,2,2,2,2,2,2,2,2,1,1,1,1,1,1,1,1,1,1,2,2,2,2,2,2,2,2,2,2,2,2,2,2,2,2,2,2,2,2,2,2,2,2,2,1,1,1,2,2,2,1,2,2,2,2,2,2,2,1,1,1,1
1,1,1,1,1,1,1,1,1,1,1,1,1,1,1,1,1,1,1,1,1,1,1,1,1,1,1,1,1,1,1,1,1,1,1,1,1,1,1,1,1,1,1,1,1,1,1,1,1,1,1,1,1,1,1,1,1,1,1,1,1,1,1,1
};
uint8_t test_dungeon1 = {
1,1,1,1,1,1,1,1,1,1,1,1,1,1,1,1,1,1,1,1,1,1,1,1,1,1,1,1,1,1,1,1,1,1,1,1,1,1,1,1,1,1,1,1,1,1,1,1,1,1,1,1,1,1,1,1,1,1,1,1,1,1,1,1
1,1,1,1,1,1,2,2,2,1,1,1,1,1,2,2,2,2,2,2,2,2,2,2,2,2,2,2,2,2,2,2,2,2,2,2,2,2,2,1,1,1,2,2,1,1,1,1,1,1,1,1,1,1,1,1,1,1,1,1,1,1,1,1
1,1,1,1,1,1,2,1,2,1,1,1,1,1,2,1,1,1,1,1,1,2,1,1,2,1,1,1,1,1,2,1,1,2,1,1,1,1,2,1,1,1,2,2,6,6,6,6,1,1,2,2,2,1,1,1,1,1,1,1,1,1,1,1
1,1,1,1,1,1,2,1,2,2,2,2,2,2,2,1,1,1,1,5,5,5,5,2,2,1,1,1,1,1,2,1,8,8,8,1,2,2,2,1,1,1,2,2,6,6,6,6,2,2,2,1,2,1,1,1,1,1,1,1,1,1,1,1
1,1,1,1,1,1,2,1,1,1,1,1,1,1,1,1,1,1,1,5,5,5,5,1,1,1,1,1,1,1,2,1,8,8,8,2,2,1,1,1,1,1,2,1,6,6,6,6,1,1,1,2,2,2,2,1,8,8,8,1,1,1,1,1
1,1,1,1,1,1,2,1,1,1,1,2,2,2,1,1,1,1,1,5,5,5,5,1,1,2,2,2,2,2,2,1,8,8,8,1,2,2,2,2,2,2,2,1,6,6,6,6,1,1,3,2,2,1,2,2,8,8,8,1,1,1,1,1
1,1,1,1,1,1,2,1,1,1,1,2,1,2,1,1,1,1,1,1,2,2,1,1,1,2,1,1,1,1,1,2,2,1,1,1,1,1,1,1,1,1,1,2,2,1,2,1,1,1,1,2,2,1,2,1,8,8,8,1,1,1,1,1
1,1,1,1,2,2,2,1,1,1,1,2,1,2,2,1,1,1,1,2,2,2,2,2,2,2,1,2,2,2,2,2,2,2,2,2,2,2,2,2,2,2,2,2,2,2,2,2,2,2,2,2,1,1,2,2,8,8,8,1,1,1,1,1
1,1,1,2,2,9,1,1,1,1,1,2,1,1,8,8,8,1,1,2,1,1,1,1,1,1,1,2,1,1,1,1,1,1,2,1,1,1,1,1,1,1,1,1,1,1,1,1,1,1,1,1,2,2,2,2,1,1,1,1,1,1,1,1
1,1,1,2,1,7,7,7,7,1,1,2,1,1,8,8,8,2,2,2,1,1,1,1,1,1,1,2,1,1,1,1,1,5,5,5,2,2,2,1,2,2,2,2,2,2,2,2,2,2,2,1,2,1,1,1,1,1,1,1,1,1,1,1
1,1,1,2,1,7,7,7,7,1,1,2,2,2,8,8,8,1,1,2,1,1,1,1,1,1,1,2,1,1,1,1,1,5,5,5,1,1,2,1,2,1,1,1,1,1,2,1,1,1,2,1,2,1,1,1,1,1,1,1,1,1,1,1
1,1,1,2,1,7,7,7,7,1,1,2,1,1,8,8,8,1,1,2,1,1,1,2,2,2,2,2,1,1,1,1,1,5,5,5,2,2,2,1,2,1,1,1,1,1,2,1,2,2,2,1,2,1,1,1,1,1,1,1,1,1,1,1
1,1,1,2,1,7,7,7,7,1,1,2,1,1,1,1,2,2,1,2,1,1,1,2,1,2,2,1,1,1,1,1,1,1,1,1,2,1,2,1,2,1,1,1,1,1,2,1,2,1,1,1,2,1,7,7,7,9,2,2,2,1,1,1
1,1,1,2,1,1,1,1,1,1,1,2,1,2,2,2,2,2,1,2,1,1,1,2,1,1,6,6,6,6,1,1,1,1,1,1,2,2,2,2,2,1,1,1,1,1,2,1,2,1,1,1,2,1,7,7,7,1,2,1,2,1,1,1
1,1,1,2,1,2,2,2,2,2,2,2,1,2,1,1,1,2,1,2,1,1,1,2,1,1,6,6,6,6,2,2,2,1,1,1,2,1,1,1,1,1,1,1,1,1,2,1,2,1,1,1,2,1,7,7,7,1,2,1,2,1,1,1
1,1,1,2,1,2,1,1,1,1,1,1,1,2,1,2,2,2,2,2,1,1,1,2,2,1,6,6,6,6,1,1,2,1,1,1,2,1,2,2,2,1,1,1,1,1,2,1,2,1,1,1,2,1,7,7,7,1,2,1,2,1,1,1
1,1,1,2,1,2,1,1,1,1,1,1,1,2,1,2,1,1,2,2,1,1,1,1,2,1,6,6,6,6,1,2,2,2,2,1,2,1,2,1,2,1,1,1,1,1,2,1,2,1,1,1,2,1,1,1,1,1,2,1,2,1,1,1
1,1,1,2,2,2,1,1,1,1,1,1,1,2,2,2,6,6,6,1,2,2,2,1,2,1,1,1,1,1,1,2,1,1,2,1,2,1,2,1,2,2,2,2,2,2,2,1,2,2,2,1,2,1,1,1,1,1,2,1,2,1,1,1
1,1,1,1,1,1,1,1,1,1,1,1,1,2,1,1,6,6,6,1,2,1,2,1,2,1,1,1,1,1,1,2,1,1,2,2,2,1,2,1,1,1,1,1,1,1,1,1,1,1,2,1,2,2,2,2,2,2,2,1,2,1,1,1
1,1,1,1,1,1,1,1,1,1,1,1,1,2,2,2,6,6,6,1,2,1,2,1,2,1,2,2,2,1,1,2,1,1,1,1,1,1,2,1,2,2,2,1,1,1,2,2,2,2,2,2,1,1,1,1,1,1,1,1,2,1,1,1
1,1,1,1,1,1,1,1,1,1,1,1,1,2,1,1,6,6,6,2,2,1,2,1,2,1,2,1,2,1,1,2,1,1,6,6,6,1,2,1,2,1,2,1,1,1,2,1,1,1,1,5,5,5,5,1,1,1,1,1,2,1,1,1
1,2,2,2,2,2,2,2,2,2,1,1,1,2,2,2,1,1,1,2,2,1,2,1,2,2,2,1,2,1,1,2,2,2,6,6,6,1,2,1,2,1,2,1,1,1,2,2,2,2,2,5,5,5,5,1,1,1,1,1,2,1,1,1
1,2,1,1,1,1,1,2,1,2,1,1,1,1,1,2,1,1,1,2,1,1,2,1,1,1,1,1,2,1,1,1,1,1,6,6,6,1,2,1,2,1,2,1,1,1,1,1,2,1,1,5,5,5,5,1,1,1,1,1,2,1,1,1
1,2,1,1,1,1,1,2,1,2,1,1,1,1,1,2,1,1,1,2,1,1,2,1,2,2,2,2,2,2,2,2,2,1,1,1,1,1,2,1,2,1,2,1,1,1,1,1,2,1,2,2,1,1,1,1,1,1,1,1,2,1,1,1
1,2,1,1,1,1,1,2,1,2,1,1,1,1,1,2,1,1,1,2,1,1,2,1,2,1,1,2,2,1,1,1,2,1,1,1,1,1,2,1,2,1,2,1,1,1,1,1,2,1,2,1,1,1,1,1,1,1,1,1,2,1,1,1
1,2,1,1,1,1,1,2,1,2,1,1,1,1,1,2,2,2,1,2,1,1,2,1,2,1,5,5,5,5,1,2,2,1,1,1,1,1,2,2,2,1,2,2,1,1,1,1,2,2,2,1,1,1,1,1,1,1,1,1,2,1,1,1
1,2,1,1,1,1,1,2,1,2,1,1,1,1,1,1,1,2,1,2,1,1,2,1,2,1,5,5,5,5,1,2,1,1,1,1,1,1,1,1,1,1,2,2,6,6,6,6,1,1,1,1,1,1,1,1,1,1,1,1,2,1,1,1
1,2,1,1,1,1,1,2,1,2,1,1,1,2,2,2,2,2,1,2,1,1,2,1,2,2,5,5,5,5,1,2,2,2,2,2,2,2,2,2,2,2,2,1,6,6,6,6,1,1,1,1,1,1,1,1,1,1,1,1,2,1,1,1
1,2,1,1,1,1,1,2,1,9,1,1,1,2,1,1,1,1,1,2,1,1,2,1,2,1,1,2,1,1,1,1,1,1,2,1,1,1,1,1,1,1,1,1,6,6,6,6,1,1,1,1,2,2,2,2,2,2,2,1,2,1,1,1
1,2,1,1,1,1,1,2,1,4,1,1,1,2,2,2,2,2,2,2,1,1,2,2,2,1,2,2,1,1,1,1,1,6,6,6,1,1,1,1,1,1,1,1,1,1,1,1,1,1,1,1,2,1,1,1,1,1,2,1,2,1,1,1
1,2,1,1,1,1,1,2,1,1,1,1,1,1,1,1,1,1,1,1,1,1,2,1,1,1,2,1,2,2,2,1,1,6,6,6,1,1,1,1,1,1,1,1,2,2,2,2,2,2,2,1,2,1,1,1,2,2,2,1,2,1,1,1
1,2,1,1,1,1,1,2,1,1,1,1,1,1,1,1,1,1,1,1,1,1,2,1,1,1,2,1,2,1,2,1,2,6,6,6,1,1,1,1,1,1,1,1,2,1,1,1,1,1,2,1,2,1,1,1,2,1,1,1,2,1,1,1
1,2,1,1,1,1,1,2,1,1,1,1,1,1,1,1,1,1,1,1,1,1,2,2,2,2,2,1,2,1,2,1,2,2,1,1,1,1,1,1,1,1,1,1,2,1,1,1,1,1,2,1,2,1,1,1,2,1,2,2,2,1,1,1
1,2,1,2,2,2,1,2,2,2,2,2,1,1,1,1,1,1,1,1,1,1,1,1,1,2,2,1,2,1,2,2,2,2,2,2,2,2,2,2,2,2,2,2,2,1,1,1,1,1,2,1,2,1,1,1,2,1,2,1,1,1,1,1
1,2,1,2,1,2,1,1,1,1,1,2,1,1,1,1,1,1,1,1,1,1,6,6,6,6,1,2,2,1,1,1,1,1,1,1,1,1,1,1,1,1,1,1,1,2,2,2,2,2,2,1,2,1,1,1,2,2,2,1,1,1,1,1
1,2,1,2,1,2,1,1,1,2,2,2,1,1,1,1,1,1,1,2,2,2,6,6,6,6,2,2,2,5,5,5,1,1,1,7,7,7,1,1,1,1,1,1,1,2,1,1,1,1,1,1,2,1,1,1,1,1,1,1,1,1,1,1
1,2,1,2,1,2,1,1,1,2,1,1,1,1,8,8,8,8,1,2,1,1,6,6,6,6,1,2,1,5,5,5,1,1,1,7,7,7,1,2,2,2,2,2,2,2,1,1,2,2,2,2,2,2,2,2,2,2,2,2,2,2,2,1
1,2,2,2,1,2,1,1,1,2,1,1,1,1,8,8,8,8,1,2,1,1,6,6,6,6,1,2,1,5,5,5,1,1,1,7,7,7,1,2,1,1,1,1,1,1,1,1,2,1,1,1,1,1,1,1,1,1,1,1,1,1,2,1
1,1,1,1,1,2,1,1,1,2,1,1,1,1,8,8,8,8,2,2,1,1,1,1,2,2,2,2,1,5,5,5,1,1,1,7,7,7,9,2,1,2,2,2,2,2,2,2,2,1,1,1,1,1,1,1,1,1,1,1,1,1,2,1
1,1,1,1,1,2,1,1,1,2,2,2,2,2,2,1,1,1,2,2,1,1,1,1,2,1,2,1,1,2,1,2,1,1,1,1,1,1,1,2,1,2,1,1,1,2,1,1,2,1,1,1,1,1,1,1,1,1,1,1,1,1,2,1
1,1,1,2,2,2,1,1,1,1,1,1,1,2,1,1,1,1,1,2,1,1,2,2,2,2,2,1,1,2,2,2,2,2,2,2,2,2,1,2,1,2,1,1,6,6,6,2,2,1,1,1,1,1,1,1,1,1,1,1,1,1,2,1
1,1,1,2,1,1,5,5,5,5,1,1,1,2,2,2,2,2,2,2,1,1,2,1,1,1,1,2,2,2,1,1,1,2,1,1,1,2,1,2,1,2,1,1,6,6,6,1,1,1,1,1,1,1,1,1,1,1,1,1,1,1,2,1
1,1,1,2,1,1,5,5,5,5,1,1,1,1,1,1,1,1,1,1,1,1,2,1,1,1,1,2,1,1,1,1,2,2,1,1,1,2,1,2,1,2,1,2,6,6,6,1,1,1,1,2,2,2,2,2,1,1,1,1,1,1,2,1
1,1,1,2,1,2,5,5,5,5,2,2,1,2,2,2,2,2,1,1,1,1,2,1,1,1,1,2,1,6,6,6,2,1,1,1,1,2,1,2,1,2,2,2,2,1,2,2,2,2,1,2,1,1,1,2,1,1,1,1,1,1,2,1
1,1,1,2,2,2,1,2,1,1,2,2,1,2,1,2,1,2,1,1,1,1,2,2,1,1,1,2,2,6,6,6,1,1,1,1,1,2,1,2,1,1,1,1,1,1,1,2,1,2,2,2,1,2,2,2,1,1,1,1,1,1,2,1
1,1,1,1,1,2,1,2,1,1,1,2,1,2,1,2,1,2,2,2,2,2,1,2,1,1,1,2,1,6,6,6,1,1,1,1,1,2,1,2,2,2,2,2,2,2,2,2,1,1,1,1,1,2,1,1,7,7,7,1,1,1,2,1
1,2,2,2,2,2,1,2,2,2,2,2,2,2,1,2,1,1,1,1,1,2,2,2,1,1,1,2,1,1,1,1,2,2,2,2,2,2,1,1,1,2,1,1,1,1,1,1,1,5,5,5,2,2,1,1,7,7,7,1,1,1,2,1
1,2,1,1,1,1,1,1,1,1,1,1,1,1,1,2,1,1,1,1,1,2,1,1,2,2,2,2,1,1,1,1,2,1,1,1,1,1,7,7,7,9,2,2,2,2,1,1,1,5,5,5,1,2,1,1,7,7,7,9,1,1,2,1
1,2,1,1,1,2,2,2,2,2,2,2,2,2,1,2,1,1,8,8,8,8,1,1,2,1,1,1,1,1,2,2,2,1,1,1,1,1,7,7,7,1,1,2,1,2,1,1,1,5,5,5,1,2,2,2,1,1,1,2,2,2,2,1
1,2,1,1,1,2,1,1,1,1,1,1,1,2,1,2,1,1,8,8,8,8,1,1,2,1,1,1,1,1,2,1,1,1,1,1,1,1,7,7,7,1,1,2,1,2,1,1,1,2,1,1,1,1,1,2,1,1,1,1,1,2,1,1
1,2,2,2,2,2,1,1,1,1,1,1,1,2,2,2,1,1,8,8,8,8,1,1,2,1,1,1,1,1,2,1,1,1,1,1,1,1,1,1,1,1,1,2,1,2,2,2,2,2,2,2,2,2,1,2,1,1,1,1,1,2,1,1
1,1,1,1,1,1,1,1,2,2,2,1,1,2,1,1,2,2,8,8,8,8,1,1,2,1,1,1,1,1,2,1,1,1,1,1,1,1,1,1,1,1,1,2,2,1,1,2,1,2,1,1,1,2,1,2,1,1,1,1,1,2,1,1
1,1,1,1,1,1,1,1,2,1,2,1,5,5,5,1,2,1,1,1,1,1,1,1,2,1,1,1,1,1,2,2,2,2,2,2,2,2,2,2,2,2,2,1,2,1,1,2,1,8,8,8,1,2,1,2,1,2,2,2,2,2,2,1
1,1,1,1,1,1,1,1,2,1,2,1,5,5,5,1,2,2,2,2,2,2,2,2,2,1,1,1,1,1,1,1,2,1,2,2,2,1,1,1,1,1,2,2,2,1,1,2,1,8,8,8,1,2,1,2,1,2,1,1,1,1,2,1
1,1,1,1,1,1,1,1,2,1,2,2,5,5,5,1,2,1,1,1,1,1,1,1,1,2,2,2,2,2,2,1,6,6,6,6,1,1,1,2,2,2,1,1,1,2,2,2,2,8,8,8,1,2,1,2,1,2,2,2,1,1,2,1
1,1,1,1,1,1,2,2,2,1,1,1,5,5,5,2,2,1,1,1,2,2,6,6,6,2,1,2,1,1,2,2,6,6,6,6,2,2,1,2,1,2,2,2,1,2,1,1,2,8,8,8,1,2,1,2,1,1,1,2,1,1,2,1
1,1,1,1,1,1,2,1,1,1,1,1,1,2,2,1,2,1,1,1,2,1,6,6,6,1,1,2,1,1,2,2,6,6,6,6,1,2,1,2,1,1,1,2,1,2,1,2,2,1,1,1,2,2,1,2,2,2,2,2,1,2,2,1
1,1,1,1,1,1,2,1,1,1,2,2,2,2,2,1,2,2,2,2,2,1,6,6,6,1,1,2,1,1,1,2,2,2,1,1,1,2,1,2,1,1,1,2,1,2,1,2,1,1,1,1,2,1,1,1,1,1,1,1,1,2,1,1
1,1,1,1,1,1,2,1,1,1,2,1,1,1,2,1,1,1,1,1,2,1,1,1,1,1,1,2,2,2,2,2,2,2,2,2,2,2,1,2,1,1,1,2,1,2,1,2,2,2,2,2,2,1,1,2,2,2,2,2,2,2,1,1
1,1,1,1,1,1,2,2,2,2,2,1,1,1,2,1,1,1,1,1,2,1,1,1,1,1,1,1,1,1,1,1,1,1,1,2,1,1,1,2,1,1,1,2,1,2,1,1,1,1,1,1,1,1,1,2,1,1,1,1,1,1,1,1
1,1,1,1,1,1,1,1,1,1,1,1,1,1,2,1,1,1,1,1,2,1,1,1,1,1,1,1,1,1,1,1,1,1,1,2,2,2,2,2,1,1,1,2,1,2,1,1,1,1,1,1,1,1,1,2,2,2,1,1,1,1,1,1
1,1,1,1,1,1,1,1,1,1,1,1,1,1,2,1,1,1,1,1,2,1,1,1,1,1,1,1,1,1,1,1,1,1,1,1,1,1,1,1,1,1,1,2,1,2,1,1,1,1,1,1,1,1,1,1,1,2,1,1,1,1,1,1
1,1,1,1,1,1,1,1,1,1,1,1,1,1,2,2,2,2,2,2,2,2,2,2,2,2,2,2,2,2,2,2,2,2,2,2,2,2,2,2,2,2,2,2,1,2,2,2,2,2,2,2,2,2,2,2,2,2,1,1,1,1,1,1
1,1,1,1,1,1,1,1,1,1,1,1,1,1,1,1,1,1,1,1,1,1,1,1,1,1,1,1,1,1,1,1,1,1,1,1,1,1,1,1,1,1,1,1,1,1,1,1,1,1,1,1,1,1,1,1,1,1,1,1,1,1,1,1
};

uint24_t test_dungeon_floors[] = { test_dungeon0 ,test_dungeon1  };
